3000110004
0102222010
0052110600
0222112020
1211001121
1211001121
0202112220
0030112400
0102222010
5000110006
