3334554333
3102222013
3060112603
4211112224
5211221125
5211221125
4222111124
3062110603
3102222013
3334554333
