3334554333
3222002223
4221001223
3221661224
5111221115
5111221115
3221661223
4221001224
3222002223
3334554333
