3334554333
3262112623
3002222003
4211111124
5122662225
5222662215
4211111124
3002222003
3262112623
3334554333
