3000000004
3221001224
0221001220
0111001110
0000002220
0000002220
0111001110
0221001220
5221001226
5000000006
