3000000004
0101111010
0000000000
0122222210
0120220210
0120220210
0122222210
0000000000
0101111010
5000000006
