3300000044
3202222024
0002222000
2211111122
2210110122
2210110122
2211111122
0002222000
5202222026
5500000066
