3330000444
3002112004
3112110114
0110022022
0110110110
0110110110
2202200110
5110112116
5002112006
5550000666
