3000000004
0112002110
0112002110
0222002220
0111000000
0111000000
0222002220
0112002110
0112002110
5000000006
