3334114333
3250220523
3562222653
4022112204
1221111221
1221111221
4022112204
3562222653
3250220523
3334114333
