3330220444
3101111014
3011111104
0111221110
2112222112
2112222112
0111221110
5011111106
5101111016
5550220666
