3330002444
3011112104
3011110104
0220002020
0110112110
0112110110
0202000220
5010111106
5012111106
5552000666
