3000000004
0200000020
0021001200
0221001220
0111221110
0111221110
0221001220
0021001200
0200000020
5000000006
