3300000044
3221001224
0221001220
0111001110
0222002220
0222002220
0111001110
0221001220
5221001226
5500000066
