3000220004
0202112020
0000220000
0211111120
0100110010
0100110010
0211111120
0000220000
0202112020
5000220006
