3021201204
3221211224
2222002222
1121111211
0101220022
2201221010
1121011211
2222002222
5221121226
5021021206
