3300220044
3202112024
0002222000
0211111120
0205112610
0132114020
0211111120
0002222000
5202112026
5500220066
