3331221444
3211211224
3222002214
1121111211
2101222022
2201221012
1121211211
5122002226
5221121126
5551221666
