3000000004
3202122024
0001501000
0221001220
2121111212
2121111212
0221001220
0001041000
5202212026
5000000006
