3332552333
3142212213
3241661443
2202212022
5162212625
5261112615
2202222022
3441661423
3122122413
3332552333
