3330110444
3102222014
3052110604
0222111020
1211121121
1211211121
0201112220
5030112406
5102222016
5550110666
