3300000044
3101125014
0001126000
1122220021
1120110011
1100110211
1200222211
0004211000
5103211016
5500000066
