3300000044
3101111014
0001111000
1122222211
1120220211
1120220211
1122222211
0001111000
5101111016
5500000066
