3330000444
3101001014
3112002114
0112002110
1222112221
1222112221
0112002110
5112002116
5101001016
5550000666
