3334554333
3111001113
4112002113
3112662114
5222112225
5222112225
3112662113
4112002114
3111001113
3334554333
