3000000004
0100000010
0012002100
0112002110
0222112220
0222112220
0112002110
0012002100
0100000010
5000000006
