3334554333
3112002113
3112002113
4222662224
5111111115
5111111115
3222662223
4112002114
3112002113
3334554333
