3334554333
3006226113
3110112113
2202220114
5116116115
5116116115
4110222022
3112110113
3116226003
3334554333
