3301221044
3101111014
0001111000
1111221111
2112222112
2112222112
1111221111
0001111000
5101111016
5501221066
