3334554333
3101111013
3061111603
4122222214
5120220215
5120220215
4122222214
3061111603
3101111013
3334554333
