3000000004
0101111010
0001111000
0111221110
0112222110
0112222110
0111221110
0001111000
0101111010
5000000006
