3334554333
3102222013
3062110603
4222111124
5211221125
5211221125
4211112224
3060112603
3102222013
3334554333
