3331222444
3200010024
3221221014
1221220612
2215010122
2210104122
2130221221
5101221226
5200100026
5552221666
