3000000004
0101125010
0001126000
1122220020
1120110220
0220110211
0200222211
0004211000
0103211010
5000000006
