3301111044
3101122014
0012220000
0212006520
0112112220
0222112110
0234002120
0000222100
5102211016
5501111066
