3330220444
3202215024
3002216004
2211110022
2210220122
2210220122
2200111122
5004122006
5203122026
5550220666
