3000000004
3200000024
0221001220
0221001220
0111221110
0111221110
0221001220
0221001220
5200000026
5000000006
