3331222444
3222221124
3022116004
1011500102
2022012212
2122102202
2010041101
5003112206
5211222226
5552221666
