3330110444
3202222024
3022222204
0222112220
1221111221
1221111221
0222112220
5022222206
5202222026
5550110666
