3331554333
3200212023
3121221213
1221220614
5216012125
5212106125
4160221221
3121221213
3202120023
3334551333
