3002222004
3202211024
0001000000
0221000650
0221221110
0111221220
0340001220
0000001000
5201122026
5002222006
