3334554333
3201111023
3061220603
4111222214
5122112215
5122112215
4122221114
3060221603
3201111023
3334554333
