3331551333
3211211423
3442662413
1101111011
5161222625
5261211615
1101211011
3142662443
3241121123
3331551333
