3334554333
3202222023
3062222603
4211111124
5210110125
5210110125
4211111124
3062222603
3202222023
3334554333
