3000220004
0201111020
0051220600
0111221010
2122002212
2122002212
0101221110
0030221400
0201111020
5000220006
