3300220044
3222221124
0022116000
1011500100
2022012212
2122102202
0010041101
0003112200
5211222226
5500220066
