3330000444
3202002024
3221001224
0221001220
2111221112
2111221112
0221001220
5221001226
5202002026
5550000666
