3330220444
3201111024
3051220604
0111222010
2122212212
2122122212
0102221110
5030221406
5201111026
5550220666
