3000220004
3202112024
0002222000
0211111120
0200110610
0130110020
0211111120
0002222000
5202112026
5000220006
