3331554333
3212221123
3022116203
1011620124
5222012215
5122102225
4210261101
3026112203
3211222123
3334551333
