3000000004
0202222020
0002222000
0222112220
0221111220
0221111220
0222112220
0002222000
0202222020
5000000006
