3000000004
0202222020
0000000000
0211111120
0210110120
0210110120
0211111120
0000000000
0202222020
5000000006
