3334554333
3221001223
3221001223
4111661114
5222222225
5222222225
3111661113
4221001224
3221001223
3334554333
