3334554333
3101126013
3001126003
4122226114
5121111225
5221111215
4116222214
3006211003
3106211013
3334554333
