3300220044
3201111024
0051220600
0111222010
2122012212
2122102212
0102221110
0030221400
5201111026
5500220066
