3331551333
3241121123
3142662443
1101121011
5261121615
5162221625
1101111011
3442662413
3211211423
3331551333
