3000000004
3202211024
0002215000
2211116012
2210220112
2110220122
2104111122
0003122000
5201122026
5000000006
