3300000044
3202122024
0001501000
0221261220
2121111212
2121111212
0221321220
0001041000
5202212026
5500000066
