3000000004
0202112020
0001001000
0201001020
2121111212
2121111212
0201001020
0001001000
0202112020
5000000006
