3001000004
3200012024
0021220010
0221220610
2215010122
2210104122
0130221220
0100221200
5202100026
5000001006
