3002112004
0112112100
0111001110
2212222122
0202110010
0102112020
2212022122
0111001110
0112112110
5002112006
