3330110444
3102222014
3050112604
0201112220
1211211121
1211121121
0222111020
5032110406
5102222016
5550110666
