3332552333
3122122413
3441661423
2202222022
5262111615
5162122625
2202122022
3241661443
3142212213
3332552333
