3000000004
0202215020
0002216000
2211110010
2210220110
0110220122
0100111122
0004122000
0203122020
5000000006
