3300000044
3200000024
0221001220
0221001220
2111221112
2111221112
0221001220
0221001220
5200000026
5500000066
