3300110044
3102222014
0050112600
0201112220
1211201121
1211021121
0222111020
0032110400
5102222016
5500110066
