3002000004
3100021014
0012110020
0112110620
1125020211
1120204211
0230112110
0200112100
5101200016
5000002006
