3331111444
3101122014
3212220004
0212006520
0112112220
0222112110
0234002120
5000222126
5102211016
5551111666
