3334554333
3122122013
3011126003
4122226124
5121111225
5221111215
4216222214
3006211103
3102212213
3334554333
