3302110044
3100020014
0112112020
0112110620
1125020211
1120204211
0230112110
0202112110
5100200016
5500112066
