3012102104
3112122114
1111001111
2212222122
0202110011
1102112020
2212022122
1111001111
5112212116
5012012106
