3002112004
0112112110
0111001110
2212202122
0102112020
0200112010
2212222122
0111001110
0112112110
5002112006
