3330110444
3101125014
3001126004
1122220011
1120110211
1120110211
1100222211
5004211006
5103211016
5550110666
