3332554333
3121112213
3011226103
2022610214
5111021125
5211201115
4120162202
3016221103
3122111213
3334552333
