3000000004
0002112000
0000110000
0110002022
0110110000
0000110110
2202000110
0000110000
0002112000
5000000006
