3300110044
3101221014
0001111000
0122222210
0105221620
0231224010
0122222210
0001111000
5101221016
5500110066
