3334554333
3202216023
3002216003
4211116224
5212222115
5112222125
4226111124
3006122003
3206122023
3334554333
