3000220004
3202221124
0022116000
1011500020
0022012210
0122102200
0200041101
0003112200
5211222026
5000220006
