3334554333
3226116003
3221220223
4220111011
5226226225
5226226225
1101110224
3220221223
3006116223
3334554333
