3000220004
3201111024
0051220600
0111221010
2122022212
2122202212
0101221110
0030221400
5201111026
5000220006
