3001221004
0221221200
0222002220
1121111211
0101220020
0201221010
1121011211
0222002220
0221221220
5001221006
