3334554333
3211211023
3022216003
4211116214
5212222115
5112222125
4126111124
3006122203
3201121123
3334554333
