3330000444
3202212024
3001061004
0221521220
2121111212
2121111212
0221241220
5001301006
5202122026
5550000666
