3330220444
3211211024
3022215004
2211116012
2210220112
2110220122
2104111122
5003122206
5201121126
5550220666
