3002200004
0202211020
0000000000
0221000650
0221221110
0111221220
0340001220
0000000000
0201122020
5000022006
