3332222444
3202222024
3002222004
2211111122
2210110122
2210110122
2211111122
5002222006
5202222026
5552222666
