3330220444
3202112024
3002222004
0211111120
0152116020
0203112410
0211111120
5002222006
5202112026
5550220666
