3000220004
0200221120
0022116000
1011500010
0022012220
0222102200
0100041101
0003112200
0211220020
5000220006
