3301220044
3200010024
0221221010
0221220610
2215010122
2210104122
0130221220
0101221220
5200100026
5500221066
