3000220004
0201111020
0050221600
0101221110
2122002212
2122002212
0111221010
0031220400
0201111020
5000220006
