3334554333
3202212023
3601221063
4221221224
5121661215
5121661215
4221221224
3601221063
3202122023
3334554333
