3021021204
3221121224
2222002222
1121101211
2201221010
0100221022
1121111211
2222002222
5221211226
5021201206
