3000220004
3201111024
0050221600
0101221110
2122202212
2122022212
0111221010
0031220400
5201111026
5000220006
