3000000004
3202222024
0002222000
0211111120
0210110120
0210110120
0211111120
0002222000
5202222026
5000000006
