3002112004
3202222024
0000220000
0222112220
0221111220
0221111220
0222112220
0000220000
5202222026
5002112006
