3300000044
3101211014
0002502000
0112162110
1212222121
1212222121
0112312110
0002042000
5101121016
5500000066
