3000110004
0101221010
0000110000
0122222210
0200220020
0200220020
0122222210
0000110000
0101221010
5000110006
