3302222044
3202221024
0001100000
0221000650
0221221110
0111221220
0340001220
0000011000
5201222026
5502222066
