3300220044
3201111024
0050221600
0102221110
2122102212
2122012212
0111222010
0031220400
5201111026
5500220066
