3334554333
3202211023
3121112003
4121226614
5221221115
5111221225
4166221214
3002111213
3201122023
3334554333
