3332222444
3202211024
3121110004
0121006510
0221221110
0111221220
0134001210
5000111216
5201122026
5552222666
