3331221444
3221121124
3122002224
1121121211
2201221012
2102221022
1121111211
5222002216
5211211226
5551221666
