3302112044
3202222024
0002222000
2222112222
1221111221
1221111221
2222112222
0002222000
5202222026
5502112066
