3334554333
3006116223
3220221223
1101110224
5226226225
5226226225
4220111011
3221220223
3226116003
3334554333
