3001000004
0200021020
0021220010
0021220610
2215010122
2210104122
0130221200
0100221200
0201200020
5000001006
