3000000004
0221001220
0221001220
0111001110
0222000000
0222000000
0111001110
0221001220
0221001220
5000000006
