3300000044
3202215024
0002216000
2211110012
2210220022
2200220122
2100111122
0004122000
5203122026
5500000066
