3334554333
3201111023
3060221603
4122221114
5122112215
5122112215
4111222214
3061220603
3201111023
3334554333
