3334554333
3116226003
3112110113
4110222022
5116116115
5116116115
2202220114
3110112113
3006226113
3334554333
