3001221004
0221221220
0222002220
1121101211
0201221010
0100221020
1121111211
0222002220
0221221220
5001221006
