3002200004
0202211020
0001110000
0221000650
0221221110
0111221220
0340001220
0000111000
0201122020
5000022006
