3321021244
3221121224
2122002222
1121101211
2201221012
2100221022
1121111211
2222002212
5221211226
5521201266
